9
# # # # # # # # 
# . A # . . . # 
# . # # . # B # 
# . . . . . . # 
# # # # # # # # 

-1 -1 -1 -1 -1 -1 -1 -1 
-1 8 9 -1 3 2 1 -1 
-1 7 -1 -1 4 -1 0 -1 
-1 6 5 4 3 2 1 -1 
-1 -1 -1 -1 -1 -1 -1 -1 

0 0 0 0 0 0 0 0 
0 1 1 0 1 1 1 0 
0 1 0 0 1 0 1 0 
0 1 1 1 1 1 1 0 
0 0 0 0 0 0 0 0 
